00000000000000000000000000000000000000000000000000
00000000000000000000000000000000000000000000000000
00000000000000000000000000000000000000000000000000
00000000000000000000000000000000000000000000000000
00000000000000000000000000000000000000000000000000
00000000000000000000000000000000000000000000000000
00000000000000000000000000000000000000000000000000
00000000000000000000000000000000000000000000000000
00000000000000000000000000000000000000000000000000
00000000000000000000000000000000000000000000000000
00000000000000000000000000000000000000000000000000
00000000000000000000000000000000000000000000000000
00000000000000000000000000000000000000000000000000
00000000000000000000000000000000000000000000000000
00000000000000000000000000000000000000000000000000
30000000000000000000000000000000000000000000000001
53000000000000000000000000000000000000000000000004
56000000000000000000000000000000000000000000000004
56000000000000000000000000000000000000000000000004
56000000000000000000000000000000000000000000000004
56000000000000000000000000000000000000000000000004
56000000000000000000000000000000000000000000000015
56000000000000000000000000000000000000000000000045
56000000000000000000000000000000000000000000000045
55300000000000000000000000000000000000000000000045
55600000000000000000000000000000000000000000000045
55600000000000000000000000000000000000000000000045
55600000000000000000000000000000000000000000000045
55600000000000000000000000012223000000000000000045
55600000000000000000000000155556000000000000000045
55600000000000000012300001555555230000000000000045
5560R00R00R00000015553000455555555300000B00B00B045
55522222222222222555552225555555555222222222222255
55555555555555555555555555555555555555555555555555
55555555555555555555555555555555555555555555555555
55555555555555555555555555555555555555555555555555
55555555555555555555555555555555555555555555555555
55555555555555555555555555555555555555555555555555

